00ww0wwwwwwwwww
w0000wwwwww0000
w0ww0wwwwwwwww0
w000www0w000ww0
w0ww000000w0000
w0ww0ww0w000www
00000ww0w0w0000
w0ww0000ww0wwww
00wwwww0ww0w00w
w00000w0000ww0w
w0www0w0ww0000w
w0ww0000w0ww0ww
w000ww0ww0ww000
www0w000w000www
000000w000w000e